#######################
#                     #
# # # # # # # # # # # #
#                     #
# # # #B#B#B#B#B# # # #
#     B         B     #
# # # # #1#B#2# # # # #
#     B BBBBBBB B     #
# # # # #3#B#4# # # # #
#     B         B     #
# # # #B#B#B#B#B# # # #
#                     #
# # # # # # # # # # # #
#                     #
#######################
